22222222222222222222
21111143334443333342
24111114341114333412
23411111411111434112
23341111111111141112
23411111111111111112
24111161111711111112
21111111111111111112
21111111111111111142
21111111111111111432
21111111111111114332
21111191111811143332
21111111111111433332
24111111111114333332
23411111111143333332
23341111111114333332
23334111111111433332
23333411111114333332
23333341111143333332
22222222222222222222