22222222222222222222
21111143333343333342
24171114333454333412
23411111444111434112
23341111111111141112
23411111444111111112
24111114333411111112
21111143333341111112
21111114333411111142
21111111434111111432
21111111141111114332
21181111111181143332
21111111111111433332
24111111111114333332
23411111111143333332
23341111111114333332
23334111111111433332
23333411181114333332
23333341111143333332
22222222222222222222